{
  "array1" : [["W","W","W","W","W"],
              ["W","P","S","L","W"],
              ["W","S","S","S","W"],
              ["W","S","M","E","W"],
              ["W","W","W","W","W"]],
  "rows1" : 5,
  "cols1" : 5,
  "array2" : [["W","W","W","W","W","W","W","W","W","W"],
              ["W","P","S","L","S","S","S","S","S","W"],
              ["W","S","S","S","S","S","S","S","S","W"],
              ["W","S","S","S","S","M","S","S","M","W"],
              ["W","S","S","S","S","S","S","S","S","W"],
              ["W","M","S","S","S","S","S","S","S","W"],
              ["W","S","S","S","S","S","S","S","S","W"],
              ["W","S","S","S","S","S","S","S","S","W"],
              ["W","S","S","S","S","S","S","S","E","W"],
              ["W","W","W","W","W","W","W","W","W","W"]],
    "rows2" : 10,
    "cols2" : 10,
  "array3" : [["W","W","W","W","W","W","W","W","W","W","W","W","W","W","W","W","W","W","W","W"],
              ["W","P","S","S","S","S","S","S","S","S","S","S","S","S","S","S","S","S","M","W"],
              ["W","S","S","S","S","S","S","S","S","S","S","S","S","S","S","S","S","S","S","W"],
              ["W","S","S","S","S","S","S","S","S","S","S","S","S","S","S","S","S","S","S","W"],
              ["W","S","S","S","S","S","S","S","S","S","S","S","S","S","S","S","S","S","S","W"],
              ["W","S","S","S","S","S","S","S","S","S","S","S","S","S","S","S","S","S","S","W"],
              ["W","S","S","S","S","S","S","S","S","S","S","S","S","S","S","S","S","S","S","W"],
              ["W","M","S","S","S","S","S","S","S","S","S","S","S","S","S","S","S","S","M","W"],
              ["W","S","S","S","S","S","S","S","L","S","S","S","S","S","S","S","S","S","S","W"],
              ["W","S","S","S","S","S","S","S","S","S","S","S","S","S","S","S","S","S","S","W"],
              ["W","S","S","S","M","S","S","S","S","S","S","S","S","S","S","S","S","S","S","W"],
              ["W","S","S","S","S","S","S","S","S","S","S","S","S","S","S","S","S","S","S","W"],
              ["W","S","S","S","S","S","S","S","S","S","S","S","S","S","S","S","S","S","S","W"],
              ["W","S","S","S","S","S","S","S","S","S","S","S","S","S","S","S","S","S","S","W"],
              ["W","S","S","S","S","S","S","S","S","S","S","S","S","S","S","S","S","S","S","W"],
              ["W","S","S","S","S","S","S","S","S","S","S","S","S","S","S","S","S","S","S","W"],
              ["W","S","S","S","S","S","S","S","S","S","S","S","S","S","S","S","S","S","S","W"],
              ["W","S","S","S","S","S","S","S","S","S","S","S","S","S","S","S","S","S","S","W"],
              ["W","S","S","S","M","S","S","S","S","S","S","S","S","M","S","S","S","S","E","W"],
              ["W","W","W","W","W","W","W","W","W","W","W","W","W","W","W","W","W","W","W","W"]],
    "rows3" : 20,
    "cols3" : 20,
  "array4" : [["W","W","W","W","W","W","W","W","W","W","W","W","W","W","W","W","W","W","W","W","W","W","W","W","W","W","W","W","W","W","W","W","W","W","W","W","W","W","W","W"],
              ["W","P","S","E","S","S","S","S","S","S","S","S","S","W","S","S","W","S","S","S","S","S","S","S","W","S","S","S","S","S","S","W","M","S","S","S","S","S","S","W"],
              ["W","S","W","S","S","S","S","S","S","S","S","S","S","S","S","S","W","S","S","S","S","S","S","S","S","S","S","S","S","W","S","W","W","W","W","W","S","W","W","W"],
              ["W","S","W","S","S","S","S","S","S","S","S","S","W","W","W","S","W","W","S","S","S","S","S","S","S","S","S","S","S","W","S","W","S","W","S","S","S","S","S","W"],
              ["W","S","W","S","S","S","S","S","S","S","S","W","W","S","W","S","S","W","S","S","S","S","S","S","S","S","S","S","S","W","S","W","S","S","W","W","S","W","S","W"],
              ["W","S","W","S","S","S","S","S","S","S","S","W","S","S","W","W","S","W","S","S","S","S","S","S","S","S","S","S","S","W","S","S","S","S","W","S","S","S","S","W"],
              ["W","S","W","S","S","S","S","S","S","S","S","W","W","S","S","W","W","W","S","S","S","S","S","S","S","S","S","S","S","W","W","S","W","W","W","W","W","W","S","W"],
              ["W","S","W","S","M","S","S","S","S","S","S","W","S","W","S","S","S","S","S","S","S","S","S","S","S","S","S","S","S","W","S","S","W","S","S","S","S","W","S","W"],
              ["W","S","W","S","S","S","S","S","S","S","S","S","S","W","S","S","W","S","S","S","S","S","S","S","W","W","W","W","S","W","S","W","W","S","W","W","S","W","S","W"],
              ["W","S","W","S","S","S","S","S","S","S","S","W","S","W","S","S","W","S","S","S","S","S","S","S","S","S","S","S","S","W","S","S","S","S","S","W","W","W","S","W"],
              ["W","S","W","S","S","S","S","S","S","S","S","S","S","W","S","S","W","S","S","S","S","S","S","S","W","W","W","W","W","W","S","S","M","S","S","S","S","S","S","W"],
              ["W","S","W","S","S","S","S","S","S","S","S","W","W","W","S","S","W","W","W","W","S","S","S","S","W","S","S","S","S","S","S","S","S","S","S","S","S","S","S","W"],
              ["W","S","W","S","S","S","S","S","S","S","S","S","S","S","S","S","S","S","S","S","S","S","S","S","W","W","W","W","S","S","S","S","S","S","S","S","S","S","S","W"],
              ["W","S","W","S","S","L","S","S","S","S","S","W","S","S","S","S","S","S","S","S","S","S","S","S","W","S","S","W","S","S","S","S","S","S","S","S","S","S","S","W"],
              ["W","S","W","S","S","S","S","S","S","S","S","W","W","S","S","S","S","S","S","S","S","S","S","S","S","S","S","W","S","S","S","S","S","S","S","S","S","S","S","W"],
              ["W","S","S","S","S","S","S","S","S","S","S","S","S","S","S","S","S","S","S","S","S","S","S","S","S","S","S","W","S","S","S","S","S","S","S","S","S","S","S","W"],
              ["W","S","W","S","M","S","S","S","S","S","S","S","S","S","S","S","S","S","S","S","S","S","S","S","S","S","S","W","S","S","S","S","S","S","S","S","S","S","S","W"],
              ["W","S","W","S","S","S","S","S","S","S","S","S","S","S","S","S","S","S","S","S","S","S","S","S","S","S","S","W","S","S","S","S","S","S","S","S","S","S","S","W"],
              ["W","S","W","S","S","S","S","S","S","S","S","S","S","S","S","S","S","S","S","S","S","S","S","S","S","S","S","W","S","S","S","S","S","S","S","S","S","S","S","W"],
              ["W","S","W","S","S","S","S","S","S","S","S","S","S","S","S","S","S","S","S","S","S","S","S","S","S","S","S","W","S","S","S","S","S","S","S","S","S","S","S","W"],
              ["W","S","W","S","S","S","S","S","S","S","S","S","S","S","S","S","S","S","S","S","S","S","S","S","S","S","S","S","S","S","S","S","S","S","S","S","S","S","S","W"],
              ["W","S","W","S","S","S","S","S","S","S","S","S","S","S","S","S","S","S","S","S","S","S","S","S","S","S","S","W","S","S","S","S","S","S","S","S","S","S","S","W"],
              ["W","S","W","S","S","S","S","S","S","S","S","S","S","S","S","S","S","S","S","S","S","S","S","S","S","S","S","W","S","S","S","S","S","S","S","S","S","S","S","W"],
              ["W","S","W","S","S","S","S","S","S","S","S","S","S","S","S","S","S","S","S","S","S","S","S","S","S","S","S","W","S","S","S","S","S","S","S","S","S","S","S","W"],
              ["W","S","W","S","S","S","S","S","S","S","S","S","S","S","S","S","S","S","S","S","S","S","S","S","S","S","S","W","S","S","S","S","S","S","S","S","S","S","S","W"],
              ["W","S","W","S","S","S","S","S","S","S","S","S","S","S","S","S","S","S","S","S","S","S","S","S","S","S","S","W","S","S","S","S","M","S","S","S","S","S","S","W"],
              ["W","S","W","S","M","S","S","S","S","S","S","S","S","S","S","S","S","S","S","S","S","S","S","S","S","S","S","W","S","S","S","S","S","S","S","S","S","S","S","W"],
              ["W","S","W","S","S","S","S","S","S","S","S","S","S","S","S","S","S","S","S","S","S","S","S","S","S","S","S","W","S","S","S","S","S","S","S","S","S","S","S","W"],
              ["W","S","W","S","S","S","S","S","S","S","S","S","S","S","S","S","S","S","S","S","S","S","S","S","S","S","S","W","S","S","S","S","S","S","S","S","S","S","S","W"],
              ["W","S","W","S","S","S","S","W","W","W","W","S","S","S","S","W","S","S","S","S","S","S","W","S","S","S","S","S","S","S","S","S","S","S","S","S","S","S","S","W"],
              ["W","S","W","S","S","S","S","S","S","S","W","S","W","W","W","W","S","S","S","S","S","S","S","S","S","S","S","W","S","S","S","S","S","S","S","S","S","S","S","W"],
              ["W","S","W","S","W","W","W","S","W","W","W","S","W","S","S","S","S","S","S","S","S","S","S","S","S","S","S","W","S","S","S","S","S","S","S","S","S","S","S","W"],
              ["W","S","W","S","W","S","W","S","W","S","S","S","W","S","W","W","S","W","S","S","S","S","S","S","S","S","S","W","S","S","S","S","S","S","S","S","S","S","S","W"],
              ["W","M","W","S","W","S","W","S","W","S","S","S","W","S","W","S","S","W","S","S","S","S","S","S","S","S","S","W","S","S","S","S","S","S","S","S","S","S","S","W"],
              ["W","S","W","S","W","S","W","W","W","W","S","S","W","S","W","W","S","W","S","S","S","S","S","W","S","S","S","W","S","S","S","S","S","S","S","S","S","S","S","W"],
              ["W","S","W","S","W","S","S","S","S","S","S","S","W","S","W","S","S","W","S","S","S","S","S","W","S","S","S","W","S","S","S","S","S","S","S","S","S","S","S","W"],
              ["W","S","W","S","W","W","S","W","S","W","S","W","W","S","W","S","S","S","W","S","W","W","S","W","W","S","S","W","S","S","S","S","S","S","S","S","S","S","S","W"],
              ["W","S","W","S","W","S","S","W","S","S","S","W","S","S","W","W","W","W","S","S","S","W","S","S","W","S","S","W","S","S","S","S","S","S","S","S","S","S","S","W"],
              ["W","S","S","S","W","W","S","W","S","W","S","W","W","S","S","W","S","S","S","W","S","W","S","W","W","S","S","W","S","S","S","S","M","S","S","S","S","S","E","W"],
              ["W","W","W","W","W","W","W","W","W","W","W","W","W","W","W","W","W","W","W","W","W","W","W","W","W","W","W","W","W","W","W","W","W","W","W","W","W","W","W","W"]],
  "rows4" : 40,
  "cols4" : 40
}